NO ./bir.xpm          
SO ./iki.xpm
WE ./uc.xpm   		
EA ./dort.xpm
F 220, 100 , 10
C 225, 30, 10

	11111111111111111111111111111111111111111111111111
		  11000000000110000000000001                 11111111111
		111000000001100000000000011                 11111101111
		1000000000110000000000001                 11111111111
		11111000011100000000000011111
		    100100000000000000000000111111111
		111111000011000001110000000000001
		1000000000110N0001110111100111111
		11110111111111011100000010001
		11110111111111011101010010001
		11000000110101011100000010001
		10000000000000001100000010001
		1110000000000011010100100011
		  110011111101010111110111100111
		111100111 1110101 111111110001
		111111111 11111111111111111111