NO ./textures/bir.xpm          
SO ./textures/iki.xpm
WE ./textures/uc.xpm   		
EA ./textures/dort.xpm
F 220, 100 , 10
C 225, 30, 10

11111111111111111111111111111111111111111111111111
100000001000000010000000100000001001	1100000011
100000001000000010000000100000001001	1111111111
100000001000000010000000100000001001
100000001000000010000000100000001001
100000001000000010000000100000001001
1000000000000000N0000000000000000001
100000000000000000000000000000000001
100000000000000000000000000000000001
100000000000000000000000000000000001
100000000000000000000000000000000001
100000000000000000000000000000000001
100000000000000000000000000000000001
100000000000000000000000000000000001
100000000000000000000000000000000001
100000000000000000000000000000000001
111111111111111111111111111111111111
1111111111111111 1111111111111111111