NO ./textures/bir.xpm        
SO ./textures/iki.xpm
WE ./textures/uc.xpm   		 
EA ./textures/dort.xpm
F 220, 100, 10
C 225, 30, 10

 111111111111111111111111111111111111111111111
100000001000000010000000100000001001	11000101
100000001000000010000000100000001001    111111111
100000001000000010000000100000001001
100000001000000010000000100000001001
100000001000000010000000100000001001
100000000000000000100000000000000001
100000000000000000000000000000000001    
100000000000000000000000000000000001
100000111000000000000000000000000001
1000001N1000000000000000000000000001
100000000000000000000000000000000001
100000000000000000000000000000000001
100000000000000000000000000000000001
100000000000000000000000000000000001 
100000000000000000000000000000000001
111111111111111111111111111111111111
1111111111111111 1111111111111111111