NO ./textures/north.xpm        
SO ./textures/south.xpm          
WE ./textures/west.xpm   		
EA ./textures/east.xpm
F 220, 100 , 10
C 225, 30, 10

11111111111111111111111111
1000000000110000000000001
1011000001110000000000001
1001000000000000000000001111111
111111111011000001110000000000001
100000000011000001110111111111111
11110111111111011100000000001
11110111111111011100000000001
11000000110101011100000000001
10000000000000001100000000001
10000000000000001101010001111
11000001110101011111011110N0111
1111111 11111111111 1111111111
1111111 11111111111 1111111111