NO ./textures/bir.xpm        
SO ./textures/iki.xpm          
WE ./textures/uc.xpm   		
EA ./textures/dort.xpm
F  0, 0,0
C  255,255, 255

111111111111111111111111
100000000000000000000001
100000000000000000000001
100000011111111100000001
10000001       100000001
11110001       100000001                           
100000011111111100000001                           
100000000000000000000011
10000000000N000000000001         
111111111111111111111111                      












