


NO ./textures/bir.xpm        


        SO              ./textures/iki.xpm          
WE ./textures/uc.xpm   		
EA ./textures/dort.xpm
F  220, 100,0,,,,,
C 225,30, 10

111111111111111111111111
100000000000000000000001
100000000000000000000001
100000011111111100000001
10000001       100000001
 11110001       10000000111111                            
100000011111111100000001     1                      
1000000000000000000000111111111111111111111111111111111111111111111111
10000000000N000000000001         
111111111111111111111111                      












