NO ./textures/north.xpm        
SO ./textures/south.xpm          
WE ./textures/west.xpm   		
EA ./textures/east.xpm
F 220, 100 , 10
C 225, 30, 10

111111111111111111111111
100000000000000000000001
100000000000000000000001
100000011111111100000001
100000011111111100000001
111100011111111100000001                           
100000011111111100000001                           
100000000000000000000011
10000000000N000000000001         
111111111111111111111111                      












